S . . . . . . X . . . X X . . . . . . . . . X . . X . . . . . . . X . X . . X . X . . X X . X . . . . . . . . . . X . . . X X . . . . . . . . . X . . X . . . . . . . X . X . . X . X . . X X . X . . . 
. X . . X . . . . . X . X . X . . . X . X . . . . . . X . . . X . . . X . X . X . X . X . . . . . . . X . . X . . . . . X . X . X . . . X . X . . . . . . X . . . X . . . X . X . X . X . X . . . . . . 
. . . . X X . . X . . . X . . X . X . . . X . . . . . . . X . X . X . X X . . . . . X . X . . . X . . . . . X X . . X . . . X . . X . X . . . X . . . . . . . X . X . X . X X . . . . . X . X . . . X . 
. X X . X . . . . . . X . X . . . . . . . . X . . X . X . . . X . X . . X X X . . X . X X . X . . . . X X . X . . . . . . X . X . . . . . . . . X . . X . X . . . X . X . . X X X . . X . X X . X . . . 
X X . . . X . . X . . X . X . . X . . . . X . X . X . X . . X . . . X . X X . X X . . . . . X X . X . . X X X X . X . . X X X . X . . . X . . . X . X . X X . X . X . . . . . . . . X . X . X X . . . . 
. . . . . X X . X . . . . . . X . . X . . . . . X . . . . . X . . . . X X X . . . . . . . . . . X . . . X . . . . . . . . . . . . X . . X . . X X . . X . X . X . . X X . X . X . X X . . . . . X . X . 
. X . . . . . . . . . . . . . . . . . . . . . X X . . X X X X . . . . X . . . . . . . X . . . . . X X X . . . . X . . . . . . . . . . . . X . X . . . X X X X . . . . X . X X . . . . . X X X . X . . X 
. . X . . X . . X . . X . X . . . X X . . . . . . . . . X . . . . . . . . . . X . X X . . . . . X . . X X . X . . . . . . X . X . . . . . . . . X . . X . X . . . X . X . . X X X . . X . X X . X . . . 
. X . X . X . . . . . X X . X . . . . . . . . . X X . . . . X . . . . . . . . X . X . . . X . . X X . . X . . . . . . . . . . . . X . . X . . X X . . X . X . X . . X X . X . X . X X . . . . . X . X . 
. . X . . . . X X . . . . X X . . . . . . X X . . . . . X . . X X . X X . . X X . X . X . . . X . . X X . . . . X . . . . . . . . . . . . X . X . . . X X X X . . . . X . X X . . . . . X X X . X . . X 
X . . . . . X X . . . . X X . X X . . . . . . . . . . . . . . . X . X . . X X X . X . X . . . . . X . . X X X X . X . . X X X . X . . . X . . . X . X . X X . X . X . . . . . . . . X . X . X X . . . . 
X . . . . X X . . . X X X . . X X . . . . X X . . . X X . . X . X . . X . . X . . . . . X . X . X X . . X . X . X X X . . . . . . . . . . . . . . . X . . . . . X . . X . . . . X . X . X . . . X . . . 
. . X . X . X X X . . . . . . . . . . . . . . . X . . . . . X . . X . . . . X . X . X . . . X . . . . . X . . . . . X . . X . . . X . . . . . . . X X . . . . . . X X . X . . . . . . . . . . . . . X X 
X . X X . . . X . X X . . . . . . . X . . . . . . . . . . . X X . . . . . . X X . . X . . . . . . . X X . . . . X . . . . . . . . . . . . X . X . . . X X X X . . . . X . X X . . . . . X X X . X . . X 
. . X . . . . . X . . X . . . X . . . . . . . X X . . . . . . X X . X . . . . . . . . . . . . . X X . . X . . . . . . . . . . . . X . . X . . X X . . X . X . X . . X X . X . X . X X . . . . . X . X . 
X X . . . . X . . . . . . . . . . . . X . X . . . X X X X . . . . X . X X . . . . . X X X . X . . X . . X . X . X X X . . . . . . . . . . . . . . . X . . . . . X . . X . . . . X . X . X . . . X . . . 
. . . X . . . . X . . . . . . . . . X X . X . . X . . . X . X . X . X . . . . . . . . . X . . . X . . . . . . . . . . . . . X . X X . . X . . X . . . . . . . X X . . X X . X . X X X . X . . . . . . X 
X . . . X X . X . X . . . . . X . X . . . . . X . . . . X X X X . . . . X X . . . X . . . . . . . X . X X . X . . . . . . X . X . . . . . . . . X . . X . X . . . X . X . . X X X . . X . X X . X . . . 
. . X X X X . X . . X X X . X . . . X . . . X . X . X X . X . X . . . . . . . . X . X . X X . . . . . . . . . . . . . . . . X . X X . . X . . X . . . . . . . X X . . X X . X . X X X . X . . . . . . X 
. . . X . . . . X X . . . . . X . . . X . X X X . . . . . . . . . . . X X . . . . . . . X . . X . . . . X . X . X X X . . . . . . . . . . . . . . . X . . . . . X . . X . . . . X . X . X . . . X . . . 
X X X X . X . X . . . . . X . . . . X X . . X . . . X X . . X . . X . . X . X . X X . . . . X . . . . . X X X X . X . . X X X . X . . . X . . . X . X . X X . X . X . . . . . . . . X . X . X X . . . . 
. . . . . . X X . . X X X X X X . . X . X . X X . X . . . . . . . . . X . X X . X . . . X . X . . . . . X . . . . . X . . X . . . X . . . . . . . X X . . . . . . X X . X . . . . . . . . . . . . . X X 
X X . X X X X X . . . . X X . . . X X . . . . . X X . . . . . . . X . . . . . . . X X . . . . . . . X X . . . . X . . . . . . . . . . . . X . X . . . X X X X . . . . X . X X . . . . . X X X . X . . X 
. X . . . . . . . . X . X . . X . . . . . . X . . X . . . . X . X . X . . . X . . X . . X . . . X . . . . . . . . . . . . . X . X X . . X . . X . . . . . . . X X . . X X . X . X X X . X . . . . . . X 
. . . . . . . . . . . . X . X X . . X . . X . . . . . . . X X . . X X . X . X X X . X . . . . . . X . . . . . . . . . . . . X . X X . . X . . X . . . . . . . X X . . X X . X . X X X . X . . . . . . X 
. . X . . X X X . . . . . X X . X X . . X X . X . . X X . . X X . . . . . . X . . . X . . . X X X . . X X . X . . . . . . X . X . . . . . . . . X . . X . X . . . X . X . . X X X . . X . X X . X . . . 
X . . . . . . X . X . . . . X X X . X . . . . X . . X . . . X . . . X . . . . . . . X . . X . . . . . . X . . . . . X X X X X X . . X X . . . . . . . . X . . X . X . X . . . X . . . . . X . . . . X . 
. . . . . X . . X . . X . . . . . X . . X . . . . X . X X . . . . . . X . . . . . X . . . X . . . . . . X . . . . . X . . X . . . X . . . . . . . X X . . . . . . X X . X . . . . . . . . . . . . . X X 
X X . . . . . X . . . . . X . . . . . . X . . . . . X . . . . . . . . . X X . . . X . X X X . . . . . . X X X X . X . . X X X . X . . . X . . . X . X . X X . X . X . . . . . . . . X . X . X X . . . . 
. . X . . . . . . . . . . . . X . . X . . X X . . X . X . X . . X X . X . X . X X . . . . . X . X . . . X . . . . . . . . . . . . X . . X . . X X . . X . X . X . . X X . X . X . X X . . . . . X . X . 
. . . . . . X . X . . . X . . . . . . X . . X X . . . . . . . . . . X . . X . . . X . . . X . . . . . . X X . . . . . . . . . X X . . X X . . . . . . . X X . X X X . . . . . . . . . . X . . X . . X . 
. X . . . . . X X . . . . . X . X . . X X X X . X . . . . X . X . X X X . . X . . X . . . . X . . . . . X . X . X X X . . . . . . . . . . . . . . . X . . . . . X . . X . . . . X . X . X . . . X . . . 
. . . . . . . X X . X X . . X . X . . X X X . . . . . . . X . X . X X . . X . . . . X X . . X . . X . . X . . . . . X X X X X X . . X X . . . . . . . . X . . X . X . X . . . X . . . . . X . . . . X . 
. . . . . . X X . . X X . . . . X . X . X . . X X . . . . . . . X . . . . X . . . . . . . X . . . X . . X X X X . X . . X X X . X . . . X . . . X . X . X X . X . X . . . . . . . . X . X . X X . . . . 
. . . . X . . . X . . X . . . X . X . X X . . X . . X . . . . X . . . . . . . X X . . . . . . . . . . . X . . . . . X . . X . . . X . . . . . . . X X . . . . . . X X . X . . . . . . . . . . . . . X X 
. . . . . . X X . . . . . . . . X X X . . X X X . . X . . . X X . X . X . . X X . . X X X . . . X X . X X . X . . . . . . X . X . . . . . . . . X . . X . X . . . X . X . . X X X . . X . X X . X . . . 
X . . . . . . . X . X X X . . . X . . X . . X . X . X X . . . . . . . . . . . . . . . . . X . . X . . . X X . . . . . . . . . X X . . X X . . . . . . . X X . X X X . . . . . . . . . . X . . X . . X . 
. . . X X . . X . X . X . . . . . . . X . . . . . . X X . . . X X . . X X . X . . X X X . . . . X X . . X . . . . . X X X X X X . . . . . . . X . X . X X . . . . X . X . . . . . X . . X . X X X X . . 
. . X . . . . . X X X X X X . . X X . . . . . . . . X . . X . X . X . . . X . . . . . X . . . . X . . . X . . . . . X X X X X X . . X X . . . . . . . . X . . X . X . X . . . X . . . . . X . . . . X . 
. X . . X . . . . . . . X . . X . X . X . . . . X X . . . . X X . . . . . . X . . . . . . . X X . . . . X X X X . X . . X X X . X . . . X . . . X . X . X X . X . X . . . . . . . . X . X . X X . . . . 
. X X X . . X X . X . X . . X . . . . . . X . X X X . . X X . . . X X . . . . . . X . . . . . X X . . . . . . . . X . . . . X . X . . . X . X X . . . . . . X X . . . X X X . . . . . . X X X X . X . X 
. . X X . . . . . . . . . X X . . X X . . . . . . . X X . X X X . . . . . . . . . . X . . X . . X . . X . . . . X . X . X . X X . . . . . . X . X . . . . . . X X X . X . X . X X X . X . . X . . X X . 
X X . X . . . X . X X X . . . . . . X X X X X X . X . . . . X . . X X . . . X X . X . . . . . . . . . . . . . . . X . . . . X . X . . . X . X X . . . . . . X X . . . X X X . . . . . . X X X X . X . X 
X . . . . X . X X . . . X . . . . . . . . X X X . . . . . . . . . . . X . X . . . X . X . . X . X X . X X . X . . . . . . X . X . . . . . . . . X . . X . X . . . X . X . . X X X . . X . X X . X . . . 
. . X . . X . . . . . . X X . . . . X . X . . X . X X . X . . . X . . . X . X . . . X X . X . . . . . . X X . . . . . . . . . X X . . X X . . . . . . . X X . X X X . . . . . . . . . . X . . X . . X . 
. . . . . . . X . . . . X . X . . . X . X X . . . . . . X X . . . X X X . . . . . . X X X X . X . X . X . . . . X . X . X . X X . . . . . . X . X . . . . . . X X X . X . X . X X X . X . . X . . X X . 
. . . . . . . . X X . X . . X . X . . . . X . X . X . X . . . . . . . . . X . . . . . X . . . . X . . . . . . . . X . . . . X . X . . . X . X X . . . . . . X X . . . X X X . . . . . . X X X X . X . X 
. . . . . . . . . . . . X . . . . . . . . . . X X . . X . . . . X X . . . . . X . . X . X X . X . . . . X . . . . . X X X X X X . . . . . . . X . X . X X . . . . X . X . . . . . X . . X . X X X X . . 
. . X . . . . . X X X X X X . . . . . . . X . X . X X . . . . X . X . . . . . X . . X . X X X X . . . . X . . . . . X . . X . . . X . . . . . . . X X . . . . . . X X . X . . . . . . . . . . . . . X X 
. X . . . . X . X . X . X X . . . . . . X . X . . . . . . X X X . X . X . X X X . X . . X . . X X . . . X X X X . X . . X X X . X . . . X . . . X . X . X X . X . X . . . . . . . . X . X . X X . . . . 
. . . . . . . X . . . X X . . . . . . . . . X . . X . . . . . . . X . X . . X . X . . X X . X . . . . . . . . . . X . . . X X . . . . . . . . . X . . X . . . . . . . X . X . . X . X . . X X . X . . . 
. X . . X . . . . . X . X . X . . . X . X . . . . . . X . . . X . . . X . X . X . X . X . . . . . . . X . . X . . . . . X . X . X . . . X . X . . . . . . X . . . X . . . X . X . X . X . X . . . . . . 
. . . . X X . . X . . . X . . X . X . . . X . . . . . . . X . X . X . X X . . . . . X . X . . . X . . . . . X X . . X . . . X . . X . X . . . X . . . . . . . X . X . X . X X . . . . . X . X . . . X . 
. X X . X . . . . . . X . X . . . . . . . . X . . X . X . . . X . X . . X X X . . X . X X . X . . . . X X . X . . . . . . X . X . . . . . . . . X . . X . X . . . X . X . . X X X . . X . X X . X . . . 
X X . . . X . . X . . X . X . . X . . . . X . X . X . X . . X . . . X . X X . X X . . . . . X X . X . . X X X X . X . . X X X . X . . . X . . . X . X . X X . X . X . . . . . . . . X . X . X X . . . . 
. . . . . X X . X . . . . . . X . . X . . . . . X . . . . . X . . . . X X X . . . . . . . . . . X . . . X . . . . . . . . . . . . X . . X . . X X . . X . X . X . . X X . X . X . X X . . . . . X . X . 
. X . . . . . . . . . . . . . . . . . . . . . X X . . X X X X . . . . X . . . . . . . X . . . . . X X X . . . . X . . . . . . . . . . . . X . X . . . X X X X . . . . X . X X . . . . . X X X . X . . X 
. . X . . X . . X . . X . X . . . X X . . . . . . . . . X . . . . . . . . . . X . X X . . . . . X . . X X . X . . . . . . X . X . . . . . . . . X . . X . X . . . X . X . . X X X . . X . X X . X . . . 
. X . X . X . . . . . X X . X . . . . . . . . . X X . . . . X . . . . . . . . X . X . . . X . . X X . . X . . . . . . . . . . . . X . . X . . X X . . X . X . X . . X X . X . X . X X . . . . . X . X . 
. . X . . . . X X . . . . X X . . . . . . X X . . . . . X . . X X . X X . . X X . X . X . . . X . . X X . . . . X . . . . . . . . . . . . X . X . . . X X X X . . . . X . X X . . . . . X X X . X . . X 
X . . . . . X X . . . . X X . X X . . . . . . . . . . . . . . . X . X . . X X X . X . X . . . . . X . . X X X X . X . . X X X . X . . . X . . . X . X . X X . X . X . . . . . . . . X . X . X X . . . . 
X . . . . X X . . . X X X . . X X . . . . X X . . . X X . . X . X . . X . . X . . . . . X . X . X X . . X . X . X X X . . . . . . . . . . . . . . . X . . . . . X . . X . . . . X . X . X . . . X . . . 
. . X . X . X X X . . . . . . . . . . . . . . . X . . . . . X . . X . . . . X . X . X . . . X . . . . . X . . . . . X . . X . . . X . . . . . . . X X . . . . . . X X . X . . . . . . . . . . . . . X X 
X . X X . . . X . X X . . . . . . . X . . . . . . . . . . . X X . . . . . . X X . . X . . . . . . . X X . . . . X . . . . . . . . . . . . X . X . . . X X X X . . . . X . X X . . . . . X X X . X . . X 
. . X . . . . . X . . X . . . X . . . . . . . X X . . . . . . X X . X . . . . . . . . . . . . . X X . . X . . . . . . . . . . . . X . . X . . X X . . X . X . X . . X X . X . X . X X . . . . . X . X . 
X X . . . . X . . . . . . . . . . . . X . X . . . X X X X . . . . X . X X . . . . . X X X . X . . X . . X . X . X X X . . . . . . . . . . . . . . . X . . . . . X . . X . . . . X . X . X . . . X . . . 
. . . X . . . . X . . . . . . . . . X X . X . . X . . . X . X . X . X . . . . . . . . . X . . . X . . . . . . . . . . . . . X . X X . . X . . X . . . . . . . X X . . X X . X . X X X . X . . . . . . X 
X . . . X X . X . X . . . . . X . X . . . . . X . . . . X X X X . . . . X X . . . X . . . . . . . X . X X . X . . . . . . X . X . . . . . . . . X . . X . X . . . X . X . . X X X . . X . X X . X . . . 
. . X X X X . X . . X X X . X . . . X . . . X . X . X X . X . X . . . . . . . . X . X . X X . . . . . . . . . . . . . . . . X . X X . . X . . X . . . . . . . X X . . X X . X . X X X . X . . . . . . X 
. . . X . . . . X X . . . . . X . . . X . X X X . . . . . . . . . . . X X . . . . . . . X . . X . . . . X . X . X X X . . . . . . . . . . . . . . . X . . . . . X . . X . . . . X . X . X . . . X . . . 
X X X X . X . X . . . . . X . . . . X X . . X . . . X X . . X . . X . . X . X . X X . . . . X . . . . . X X X X . X . . X X X . X . . . X . . . X . X . X X . X . X . . . . . . . . X . X . X X . . . . 
. . . . . . X X . . X X X X X X . . X . X . X X . X . . . . . . . . . X . X X . X . . . X . X . . . . . X . . . . . X . . X . . . X . . . . . . . X X . . . . . . X X . X . . . . . . . . . . . . . X X 
X X . X X X X X . . . . X X . . . X X . . . . . X X . . . . . . . X . . . . . . . X X . . . . . . . X X . . . . X . . . . . . . . . . . . X . X . . . X X X X . . . . X . X X . . . . . X X X . X . . X 
. X . . . . . . . . X . X . . X . . . . . . X . . X . . . . X . X . X . . . X . . X . . X . . . X . . . . . . . . . . . . . X . X X . . X . . X . . . . . . . X X . . X X . X . X X X . X . . . . . . X 
. . . . . . . . . . . . X . X X . . X . . X . . . . . . . X X . . X X . X . X X X . X . . . . . . X . . . . . . . . . . . . X . X X . . X . . X . . . . . . . X X . . X X . X . X X X . X . . . . . . X 
. . X . . X X X . . . . . X X . X X . . X X . X . . X X . . X X . . . . . . X . . . X . . . X X X . . X X . X . . . . . . X . X . . . . . . . . X . . X . X . . . X . X . . X X X . . X . X X . X . . . 
X . . . . . . X . X . . . . X X X . X . . . . X . . X . . . X . . . X . . . . . . . X . . X . . . . . . X . . . . . X X X X X X . . X X . . . . . . . . X . . X . X . X . . . X . . . . . X . . . . X . 
. . . . . X . . X . . X . . . . . X . . X . . . . X . X X . . . . . . X . . . . . X . . . X . . . . . . X . . . . . X . . X . . . X . . . . . . . X X . . . . . . X X . X . . . . . . . . . . . . . X X 
X X . . . . . X . . . . . X . . . . . . X . . . . . X . . . . . . . . . X X . . . X . X X X . . . . . . X X X X . X . . X X X . X . . . X . . . X . X . X X . X . X . . . . . . . . X . X . X X . . . . 
. . X . . . . . . . . . . . . X . . X . . X X . . X . X . X . . X X . X . X . X X . . . . . X . X . . . X . . . . . . . . . . . . X . . X . . X X . . X . X . X . . X X . X . X . X X . . . . . X . X . 
. . . . . . X . X . . . X . . . . . . X . . X X . . . . . . . . . . X . . X . . . X . . . X . . . . . . X X . . . . . . . . . X X . . X X . . . . . . . X X . X X X . . . . . . . . . . X . . X . . X . 
. X . . . . . X X . . . . . X . X . . X X X X . X . . . . X . X . X X X . . X . . X . . . . X . . . . . X . X . X X X . . . . . . . . . . . . . . . X . . . . . X . . X . . . . X . X . X . . . X . . . 
. . . . . . . X X . X X . . X . X . . X X X . . . . . . . X . X . X X . . X . . . . X X . . X . . X . . X . . . . . X X X X X X . . X X . . . . . . . . X . . X . X . X . . . X . . . . . X . . . . X . 
. . . . . . X X . . X X . . . . X . X . X . . X X . . . . . . . X . . . . X . . . . . . . X . . . X . . X X X X . X . . X X X . X . . . X . . . X . X . X X . X . X . . . . . . . . X . X . X X . . . . 
. . . . X . . . X . . X . . . X . X . X X . . X . . X . . . . X . . . . . . . X X . . . . . . . . . . . X . . . . . X . . X . . . X . . . . . . . X X . . . . . . X X . X . . . . . . . . . . . . . X X 
. . . . . . X X . . . . . . . . X X X . . X X X . . X . . . X X . X . X . . X X . . X X X . . . X X . X X . X . . . . . . X . X . . . . . . . . X . . X . X . . . X . X . . X X X . . X . X X . X . . . 
X . . . . . . . X . X X X . . . X . . X . . X . X . X X . . . . . . . . . . . . . . . . . X . . X . . . X X . . . . . . . . . X X . . X X . . . . . . . X X . X X X . . . . . . . . . . X . . X . . X . 
. . . X X . . X . X . X . . . . . . . X . . . . . . X X . . . X X . . X X . X . . X X X . . . . X X . . X . . . . . X X X X X X . . . . . . . X . X . X X . . . . X . X . . . . . X . . X . X X X X . . 
. . X . . . . . X X X X X X . . X X . . . . . . . . X . . X . X . X . . . X . . . . . X . . . . X . . . X . . . . . X X X X X X . . X X . . . . . . . . X . . X . X . X . . . X . . . . . X . . . . X . 
. X . . X . . . . . . . X . . X . X . X . . . . X X . . . . X X . . . . . . X . . . . . . . X X . . . . X X X X . X . . X X X . X . . . X . . . X . X . X X . X . X . . . . . . . . X . X . X X . . . . 
. X X X . . X X . X . X . . X . . . . . . X . X X X . . X X . . . X X . . . . . . X . . . . . X X . . . . . . . . X . . . . X . X . . . X . X X . . . . . . X X . . . X X X . . . . . . X X X X . X . X 
. . X X . . . . . . . . . X X . . X X . . . . . . . X X . X X X . . . . . . . . . . X . . X . . X . . X . . . . X . X . X . X X . . . . . . X . X . . . . . . X X X . X . X . X X X . X . . X . . X X . 
X X . X . . . X . X X X . . . . . . X X X X X X . X . . . . X . . X X . . . X X . X . . . . . . . . . . . . . . . X . . . . X . X . . . X . X X . . . . . . X X . . . X X X . . . . . . X X X X . X . X 
X . . . . X . X X . . . X . . . . . . . . X X X . . . . . . . . . . . X . X . . . X . X . . X . X X . X X . X . . . . . . X . X . . . . . . . . X . . X . X . . . X . X . . X X X . . X . X X . X . . . 
. . X . . X . . . . . . X X . . . . X . X . . X . X X . X . . . X . . . X . X . . . X X . X . . . . . . X X . . . . . . . . . X X . . X X . . . . . . . X X . X X X . . . . . . . . . . X . . X . . X . 
. . . . . . . X . . . . X . X . . . X . X X . . . . . . X X . . . X X X . . . . . . X X X X . X . X . X . . . . X . X . X . X X . . . . . . X . X . . . . . . X X X . X . X . X X X . X . . X . . X X . 
. . . . . . . . X X . X . . X . X . . . . X . X . X . X . . . . . . . . . X . . . . . X . . . . X . . . . . . . . X . . . . X . X . . . X . X X . . . . . . X X . . . X X X . . . . . . X X X X . X . X 
. . . . . . . . . . . . X . . . . . . . . . . X X . . X . . . . X X . . . . . X . . X . X X . X . . . . X . . . . . X X X X X X . . . . . . . X . X . X X . . . . X . X . . . . . X . . X . X X X X . . 
. . X . . . . . X X X X X X . . . . . . . X . X . X X . . . . X . X . . . . . X . . X . X X X X . . . . X . . . . . X . . X . . . X . . . . . . . X X . . . . . . X X . X . . . . . . . . . . . . . X X 
. X . . . . X . X . X . X X . . . . . . X . X . . . . . . X X X . X . X . X X X . X . . X . . X X . . . X X X X . X . . X X X . X . . . X . . . X . X . X X . X . X . . . . . . . . X . X . X X . . . E 
